######################
I....................#
#....................#
#..............##....#
#...............#....#
#....................#
#....................#
#..............####.##
#...####.........##.O#
######################
