###################
#.................#
I..........#.##.#.#
#.................#
#.................#
#....#....##.#....#
#....#....#..#..#.#
#.........#..#..#.#
#.................#
#....#...##.##....#
#.................#
#.........####..#.#
#...####..........#
#...###...........O
###################
