############################
##.......................###
##.#......##.###.#...##.####
##.#.###..##.###.#...##.####
##...........##......##.####
#....###..#####.###.###.####
####.###.######.###.###.####
####.###.##...............##
####.###.##.#.#.###.#####.##
#.............#.###........#
#.##..........#.###.#####..#
#.##.##..##...#.#########..#
#.##.##..........########..#
#.##.##.###...##.########..#
#.##.##.###...##.########..#
#.##.##.###...##.########..#
I................########..#
#......................##..O
############################
