##I#########################
#..######..................#
#....####..............###.#
####.####.#........##..###.#
#.........#..#.#...##..###.#
#................####..###.#
#..#..####......#####......#
#.......##.##...#####.####.#
#.....#.##.##...#####.####.#
#..#..#.##......##########.#
#..#..#.##.####.############
#.....#.........O###########
############################
