#############################
#.....#.###########....##.###
#.....#.############.#.##.###
#.#####.############.#.##.###
#.#####.#########.........###
#.......#######.#.#.......#.#
#...............#.#..#.#..#.#
#..#.#..........#.#..#.#..#.#
#.......######..#.#..#.#....#
#..##...######..#.#....#.##.#
#..##...........#.#..#.#.##.#
#..##...###.....#.#..#.#.##.#
#..##...#...................#
#..##...#.####.........#..#.#
I.......#.####..###....#....#
#...........##..............O
#############################
