###############
#.............#
I.#.##.#.####.#
#.#.#..#.####.#
#........####.#
#...##...####.#
#.......#####.#
#.......#####.#
#..#....##....#
#.............#
#......#......#
#.##.........##
#.##..........#
#............O#
###############
