###################################
#.................................#
#.#####.###.......................#
#.#####.###..###.###..............#
#.#####.###..###.###..............#
#.#####.###..###.###.###.#.#......#
#.#####.###..###.###.###.#.#.####.#
#.#####.###..###.###.###.#.#.####.#
#........##...##.###.###.#.#.####.#
#.#####..##...##.###.#............#
#.#####..##...##.###.#.#.#.#.####.#
#.#####..##...##.###.#.#.#.#.####.#
#.#####..##...##..................#
#........##.......................#
#....#...##................#.####.#
#.##.#...............#.#.#.#.####.#
#.##.#.#.##...##.####.........###.#
#.##.#.#.##...##.####..#.#.#..###.#
#.##.#.#.##...##.####..#.#.#..###.#
#.##.#............................#
#.................................#
#.#..###.##...##.####.##.#.#..###.#
#.#..###.##...##.####.##.#.#..###.#
#.#......##...##.####.##.#.#..###.#
I.............................###.#
#.#..######...##.####.##.#....###.#
#.#...........##.####.##.#....###.#
#.#.#########.##.####.##.#....###.#
#.#.#########.##.####.##.#..#.###.#
#.................................O
#.#.#########.##.####.####..#.#####
#.#.#########.##.####.####..#.#####
#.#.#########.##.####.####..#.#####
#.#.#########.##.####.####..#.#####
#.#.#########.##.####.####..#.#####
#.#.#########.##.####.####..#.#####
#.#.#########.##.####.####..#.#####
#.#.#########.##.####.####..#.#####
#.............................#####
###################################
