###############
#.............#
#.............#
#.............#
#..#...##.#.#.#
#.............#
#..#...##.#.#.#
#......##.#...#
#...........#.#
#.............#
#..#...##.....#
#..#...##.#.#.#
#.............#
#..#...##.#.#.#
#...........#.#
#.............#
#.............#
#..#...##.#...#
I..#...##.#...#
#.............O
###############
